take a peek	Rzuć okiem	
make them up	uzupełnij je	
persevere	wytrwać	
daunting	zniechęcające	
thriving	kwitnący	
wzmacniać	strengthen	
innuendo	insynuacja	
indigenous	rodzimy	
facilitate	ułatwiać	
emergency	nagły wypadek	
candid	szczery	
disrupt	zakłócać	
entrusted	powierzony	
avert	zapobiec	
benignly	łagodnie	
writhing	wijąc się	
look upon	spójrz na	
come out the top	wyjdź na szczyt	
incense	kadzidło	
nativity play	jasełka	
literacy	alfabetyzacja	
squander	zmarnować	
contention	twierdzenie	
take a glimpse	rzucić okiem	
venture	przedsięwzięcie	
invigorating	orzeźwiający	
augment	zwiększać	
tap into	wykorzystać	
prolific	płodny	
trope	przenośnia	
cast down	rzucać	
retreat	wycofać się	
chariot	rydwan	
surpass	przewyższać	
obscure	niejasny	
clamp	Zacisk	
clamp down	ukrócić	
ponder	rozważać	
hinder	utrudniać	
bondage	niewola	
fate	los	
Conscientiousness	Sumienność	
Conscience	Sumienie	
stance	postawa	
lesions in spinal cord	zmiany w rdzeniu kręgowym	
diminish	zmniejszać	
dwindle	słabnąć	
fatigue	zmęczenie	
futility	daremność	
plead not guilty	nie przyznać się do winy	
leading up to	prowadzące do	
carry out	wykonać	
I was responsible for maintenance and developing new features of platform used internally by banks across the world to process payments	Byłem odpowiedzialny za utrzymanie i rozwój nowych funkcji platformy wykorzystywanej wewnętrznie przez banki na całym świecie do przetwarzania płatności	
serendipity	szczęśliwy traf	
bizarre	dziwaczny	
glare	blask	
ambience	atmosfera	
make through	przejść	
judicially	sądowo	
thickness	grubość	
snapped	pękło	
roughly	w przybliżeniu	
right away	od razu	
riddled with errors	pełen błędów	
head chef	szef kuchni	
whereabouts	miejsce pobytu	
midway	w połowie drogi	
thorough	dokładny	
albeit	aczkolwiek	
hanging out	spędzając czas poza domem	
extent	stopień	
hooked up	podłączony	
oblivious	niepomny	
cordial	serdeczny	
walking along	iść wzdłuż	
drove past me	przejechał obok mnie	
whatsoever	cokolwiek	
heightened	podwyższony	
self-inflicted	samookaleczenia	
alludes	nawiązuje	
refrains	powstrzymuje się	
scabs	strupy	
refute allegation	obalić zarzuty	
budge	drgnąć	
gauge	wskaźnik	
relentless	bezwzględny	
admissible	dopuszczalny	
remorse	żal	
sustained	trwały	
tourniquet	opaska zaciskająca	
sisnister somber or ghastly	złowieszczy ponury lub straszny	
ruthless	bezwzględny	
distress signal	Sygnał o niebezpieczeństwie	
audible	słyszalny	
inclination	nachylenie	
I don't really feel like standing still	Naprawdę nie mam ochoty stać w miejscu	
unlikely	mało prawdopodobne	
accolades	pochwały	
getting his meaning across	przekazując jego znaczenie	
master the skill	opanuj umiejętność	
ustapić pierwszenstwa	give way	
run across	przebiec przez	
dismiss	oddalić	
disregard	lekceważenie	
complacency	samozadowolenie	
trustworthy	godna zaufania	
reliable	niezawodny	
have got to	musieć	
drive shaft	wał napędowy	
compressing	ściskanie	
severely	surowo	
suit	garnitur	
obtaining	uzyskanie	
ghastly	upiorny	
somber	ponury	
sinister	złowrogi	
grim	ponury	
restraint	powściągliwość	
abrupt	nagły	
jerk	szarpnięcie	
abdomen	brzuch	
on bail	za kaucją	
overturned	wywrócony	
damning	potępiający	
shedding weight	schudnąć	
confine	ograniczać	
frantic	oszalały	
disposition	usposobienie	
demise	zgon	
umitigated	prawdziwy	
blatant	krzykliwy	
inflict	zadać	
wayside	przydrożny	
apprehend	zrozumieć	
disposed	usunięte	
conviction	przekonanie	
hightened	podwyższony	
caution	Uwaga	
oblivion	zapomnienie	
dashed	przerywana	
mistress	kochanka	
deterioration	pogorszenie	
intermingled	wymieszane	
mushy	bzdurny	
moderation	umiar	
soggy	rozmoczony	
breadcrumb	bułka tarta	
pastries	ciastka	
precarious	niepewny	
pancake	naleśnik	
waffle	wafel	
muffin	muffinka	
blueberry	Borówka amerykańska	
donut	pączek	
orchard	sad owocowy	
sour	kwaśny	
melting pot	tygiel	
unappetizing	nieapetyczny	
contempt	pogarda	
act it out	odegrać to	
tormenting	dręczenie	
sigh	westchnienie	
load up	załadować	
bids	oferty	
zjawisko	phenomenon	
prey	zdobycz	
banged up	uderzył	
twisted	skręcone	
najwidoczniej	apparently	
reign	królować	
puberty	pokwitanie	
atrocities	okrucieństwa	
distorted	zniekształcony	
niepokojacy	disturbing	
unsettling	niepokojące	
maligned	oczerniany	
pons	pons	
bash	grzmotnąć	
shepherd pie	ciasto pasterskie	
hot pot	gorący garnek	
fuss	zamieszanie	
prawn	krewetka	
shrimp	Krewetka	
tier	poziom	
persecuted	prześladowany	
has yet to convince	jeszcze się nie przekonał	
slip up	potknięcie	
get back at him	odpisz mu	
rip tide	Prąd odpływowy	
stark	sztywny	
out in the woods	w lesie	
counteract	przeciwdziałać	
step up	zintensyfikować	
embodies	ucieleśnia	
przeszedł na drugą stronę	passed over to the other side	
took pity on him	zlitował się nad nim	
despised	pogardzany	
inn	Zajazd	
reimburse	zwracać koszty	
yet has endured	jeszcze przetrwał	
misfortune	nieszczęście	
broadcast	nadawanie	
tangerine	mandarynka	
appeased	zaspokojony	
divide	podzielić	
according to	według	
across the political divide	ponad podziałami politycznymi	
you are running on it	biegasz po nim	
although	mimo że	
cornerstone	kamień węgielny	
over and over again	w kółko	
and hardly many	i prawie nie wiele	
each of which holds	z których każdy posiada	
nie mylić	not to be confused	
prejudice	uprzedzenie	
idiosyncratic	specyficzny	
put forth	mobilizować	
forth	naprzód	
perhaps	być może	
first and foremost	przede wszystkim	
utterances	wypowiedzi	
whereby	w wyniku czego	
devolve	przenieść na kogoś	
insofar	o ile	
turnover	obrót handlowy	
zastane struktury	existing structures	
stand up	Wstań	
figurative	symboliczny	
participle	imiesłów	
tip down	przechylić się	
lay off	odpocząć sobie	
quality	jakość	
taking a toll	zbiera żniwo	
corny	staromodny	
abruptly	nagle	
skyrocketing	gwałtownie rośnie	
podział na lewice i prawice	division into left and right	
elsewhere	gdzie indziej	
holding up signs	trzymanie znaków	
genocide	ludobójstwo	
provincial	prowincjonalny	
parochial	parafialny	
differential	mechanizm różnicowy	
parish	parafialny	
coming apart	rozpadają się	
modeled after	wzorowane na	
welfare	dobrobyt	
Despite this	Pomimo tego	
dispossessed	wywłaszczony	
holding someone to account	pociąganie kogoś do odpowiedzialności	
backlash	reakcja	
perks	profity	
half as many	o połowę mniej	
vulnerability	słaby punkt	
in keeping with	zgodnie z	
in the wake of	w następstwie	
to be intact	być nienaruszonym	
resolution	rozkład	
all the way up to	aż do	
mind boggling	zadziwiające	
as far as I was concerned	jeśli o mnie chodzi	
hardly ever	prawie nigdy	
other than	inny niż	
sub trait	cecha podrzędna	
can't pass through	nie może przejść	
perennial	bylina	
dizziness	zawroty głowy	
to guide yourself with	do prowadzenia się	
inexplicable	niewytłumaczalny	
transform	przekształcać	
propelling, jittery, gawky, manner	napędzający, roztrzęsiony, niezgrabny, maniery	
secret oath	tajna przysięga	
chafing	otarcia	
at the drop of a hat	na każde skinienie	
tuition fees	czesne	
mediocre	przeciętny	
careful	ostrożny	
dismal	ponury	
there is way more than that to you	jest dla ciebie o wiele więcej	
bring it out	wydobyć to	
pathetic	żałosne	
demeaning	poniżające	
worthwhile	wart	
zapadło mi w pamięć	stuck in my memory	
stuck in my memory	utkwiło mi w pamięci	
divination	wróżbiarstwo	
wells	studnie	
pull to the surface	wyciągnąć na powierzchnię	
cord	sznur	
up to a point	aż do punktu	
wishy-washy	niewyraźny	
demeanor	postawa	
demean	poniżać	
shove	pchnięcie	
deemed	uznano	
thereby	a tym samym	
beside	oprócz	
disown	zapierać się	
hardly noticeable	ledwo zauważalne	
banished	wygnany	
coax	nakłaniać	
therefore	w związku z tym	
allegedly	rzekomo	
so to speak	że tak powiem	
frowned upon	źle widziane	
shunned	unikał	
unbridled	nieokiełznany	
obedient	posłuszny	
hitherto	dotychczas	
at odds	w sprzeczności	
injunctions	wskazania	
entails	pociąga za sobą	
poses	pozy	
mustering	zbiórka	
susceptibility	podatność	
imperative	tryb rozkazujący	
self ownership	własność	
emboldened	ośmielony	
simmering	gotowanie	
apparent	pozorny	
bitterness	gorycz	
weaklings	słabeusze	
sculpt	rzeźbić	
instantaneous	natychmiastowy	
malevolent	wrogi	
rustle	szelest	
guttural	gardłowy	
disinhibited	uwolniony	
regard	wzgląd	
taken aback	zaskoczony	
infatuated	zakochany	
cover up	ukryć	
modest	skromny	
happily	szczęśliwie	
ever after	na zawsze	
bleak image	ponury obraz	
ultra-tight-knit	bardzo ciasna dzianina	
uneven	nierówny	
resorted	uciekł się	
mundane	doczesny	
indifferent	obojętny	
bland	mdłe	
joyful	radosny	
lackluster	Lśniący	
assimilated	zasymilowane	
ill-fated	niefortunny	
self-assured	zadufany w sobie	
lawn	trawnik	
swing-set	huśtawka	
resembled	przypominał	
directionless	bezkierunkowy	
eagerly looking forward	z niecierpliwością czekam	
poignant	wzruszający	
hefty	mocny	
sustainable	zrównoważony	
hindrance	przeszkoda	
pulled together	zebrane razem	
tangible	namacalny	
pledge	zastaw	
divesting pension fund	zbycie funduszu emerytalnego	
drought	Okres suszy	
momentum	pęd	
greenhouse	szklarnia	
attainable	osiągalny	
persuaded	przekonany	
emphasis	nacisk	
midwife	położna	
bliskość	closeness	
chalk	kreda	
seam	szew	
cupping	bańki	
move it over	przesuń to	
cuff	mankiet	
sleeve	rękaw	
axis	oś	
superstition	zabobon	
superficial	powierzchowny	
superior	lepszy	
utterly	całkowicie	
conferring	naradzający	
crop up	pojawić się	
vicious	złośliwy	
famished	głodny	
pun	gra słów	
swollen	spuchnięty	
swallowing	łykanie	
bailed on	zwolniony za kaucją	
ditch	rów	
lantern	latarnia	
ubiquitous	wszechobecny	
visceral	trzewiowy	
transgression	przestępstwo	
standouts	wyróżnienia	
ravaged	spustoszony	
damsel in distress	dziewczyna w niebezpieczeństwie	
expendable	przeznaczony na stracenie	
arguably	prawdopodobnie	
climax	punkt kulminacyjny	
repulsive	odpychający	
benevolent	życzliwy	
sassy	impertynencki	
overinflated	przepełniony	
shampoo	szampon	
grocery	sklep spożywczy	
tycoon	potentat	
conceive	pojąć	
callous	stwardniały	
riveter	nitownica	
dandruff	łupież	
minced	mielony	
handout	materiały informacyjne	
stringent	przekonywający	
plunge	pogrążać	
slumped	osunął się	
surge	przypływ	
soar	szybować	
rocket	rakieta	
thrive on	rozwijać się dalej	
thrive	prosperować	
undertake	podjąć	
uncanny	niesamowity	
right back	z powrotem	
clacker	klakier	
jaded	sterany	
fierce	dziki	
spunky	odważny	
errands	sprawunki	
downright	szczery	
haughtiness	wyniosłość	
felonies	przestępstwa	
hoax	oszustwo	
misdemeanors	wykroczenia	
manslaughter charge	zarzut zabójstwa	
exemplary	przykładowy	
prosecute	zaskarżyć	
taking toll	zbiera żniwo	
scrutiny	badanie	
splash	pluśnięcie	
fielding	polowanie	
dish out	rozdać	
lean in	pochylić się	
incentive	zachęta	
romping	brykanie	
despicable	podły	
iconoclast	ikonoklasta	
ramping up	rośnie	
uphold	podtrzymywać	
upended	wywrócony	
apricot	morela	
hunch	przeczucie	
altar	ołtarz	
ramp up	przyspieszyć	
brethren	bracia	
buck teeth	wystające zęby	
scrambling	mieszanie się	
aftermath	następstwa	
ushered	wprowadzony	
usher	bileter	
siege	oblężenie	
notable	znaczny	
shuttle	czółenko	
wildfire	pożar	
malfunction	awaria	
acquitted	uniewinniony	
arson	podpalenie	
every once in awhile	raz na jakiś czas	
off guard	zaskoczony	
ovarian cancer	rak jajnika	
uttered	wypowiedziane	
vault	sklepienie	
half-hearted	bez entuzjazmu	
slinked off	zsunął się	
blunder	pomyłka	
unbeknownst	bez wiedzy	
rust	rdza	
ruse	podstęp	
pleaded	przyznał się	
captivated	urzeczony	
telethon	telethon	
fathom	pojąć	
held up	podniósł się	
implored	błagał	
lip-synced	zsynchronizowanie ustne	
salvage	odzysk	
ordeal	ciężka próba	
blaze	płomień	
wardrobe	szafa	
hearings	przesłuchania	
irrelevant	nieistotny	
insufferable	nieznośny	
casket	kasetka	
abbey	opactwo	
gasp	łapanie tchu	
fair-enough	Słusznie	
goof around	wygłupiać się	
handkerchief	chusteczka	
overdue	zaległy	
impaired	upośledzony	
tickling	łaskotanie	
stems from	wywodzi się z	
benign	łagodny	
harp on	ględzić	
picky	wybredny	
unraveled	rozpruty	
outspoken	szczery	
relentlessly	bezlitośnie	
chagrin	zmartwienie	
contender	zawodnik	
contingent	kontyngent	
pining	tęskni	
spiteful	złośliwy	
let him off the hook	wypuść go z haczyka	
scattered	rozsiany	
repulsion	odpychanie	
equation	równanie	
equity	kapitał	
knock-off	knock-off	
seize	chwycić	
ceasefire	zawieszenie broni	
come in handy	się przydać	
fester	ropieć	
lisping	seplenienie	
staggering	oszałamiający	
crook	oszust	
rough	szorstki	
obnoxious	nieprzyjemny	
suds	mydliny	
inflate	nadmuchać	
renowned	słynny	
considerable	znaczny	
genocider	ludobójca	
impunity	bezkarność	
first time around	pierwszy raz	
rudimentary	prymitywny	
primordial	pierwotny	
mourn	opłakiwać	
savvy	rozumieć	
inept	niedorzeczny	
onset	początek	
conjure	czarować	
eligible looters	uprawnieni szabrownicy	
officiating	sędziowanie	
loathe	brzydzić	
go after	podążać za	
puke	rzygać	
pinnacle	szczyt	
flattering	pochlebny	
crummy	kiepski	
bosom	biust	
casualties	ofiary wypadku	
detest	brzydzić	
foreshadow	zwiastować	
toiled away	trudził się	
tenet	dogmat	
concealing	ukrywanie	
confounded	zmieszany	
caterpillars	gąsienice	
throwing up	wymiotować	
lift out	wyciągnąć	
heirloom	scheda	
cooties	łuski	
minks	norki	
hold out	wytrzymać	
mingle	mieszać	
eviction	eksmisja	
tampering	manipulowanie	
ludicrous	śmieszny	
credence	wiara	
provisional	tymczasowy	
abomination	wstręt	
whippings	bicze	
hands off	ręce przy sobie	
stride	krok	
clash	starcie	
carried out	przeprowadzone	
chastised	ukarany	
moors	wrzosowiska	
crunk up	skurczył się	
stitches	szwy	
livelong	Żyj długo	
lyme disease	Borelioza	
blossom	kwitnąć	
merriment	wesołość	
whipped potatoes	ubite ziemniaki	
peas	groszek	
fetus	płód	
smirky	uśmiechnięty	
hums	buczenie	
carve	rzeźbić	
by all means	za wszelką cenę	
lousy	parszywy	
jolly	wesoły	
sobbing	szlochanie	
rubble	gruz	
flocking	uciekają	
vessel	naczynie	
slugger	slugger	
appraise	oceniać	
scum	szumowiny	
tonsils	migdałki	
woozy	mający zawroty głowy	
fling	rzucać	
nauseous	nudny	
weave	splot	
shrink	kurczyć się	
mittens	rękawice	
bail on me	kaucja za mnie	
stick a pin in it	wbij w to szpilkę	
brag	przechwalać	
clenching	zaciskanie	
cuddling	przytulanie	
blazed	płonął	
proofreading	korekta	
weep	płakać	
draw cards	dobrać karty	
humming	brzęczący	
chuckles	chichocze	
promiscuous	bezładny	
mischievous	złośliwy	
mischief	psota	
cornered	osaczony	
worse off	w gorszej sytuacji	
dangle	dyndać	
peanut	arachid	
reprehensible	naganny	
snubbed	lekceważony	
keep up	nadążać	
smock	bluza	
cumbersome	nieporęczny	
homeroom	lekcja wychowawcza	
overalls	kombinezon	
milieu	środowisko	
vintage	zabytkowe	
grip	uchwyt	
reaffirms	potwierdza	
hooker	prostytutka	
obituary	pośmiertny	
stomping	tupiąc	
scuff	zdzierać	
grievances	skargi	
excessive	nadmierny	
virility	męskość	
huts	chaty	
flick	trzepnięcie	
pounce	pazur	
apiece	kawałek	
skit	skecz	
enthused	zachwycony	
screening	ekranizacja	
needle	igła	
strap	pasek	
insulation	izolacja	
opt	optować	
sanity	zdrowie psychiczne	
cranberry	żurawina	
buckles	klamry	
ditzy	zawrotny	
whiny	płaczliwy	
insecure	niepewny	
upstate	północna część stanu	
superintendent	superintendent	
hedges	żywopłoty	
ribbed	żebrowany	
dues	składki	
goober	Fistaszek	
caught up with me	dogonił mnie	
coming on to me	zbliża się do mnie	
ran out on us	zabrakło nam	
put in a call	zadzwonić	
projectile	pocisk	
revel	biesiada	
uptight	spięty	
cello	wiolonczela	
muttering	mamroczący	
barnyard	gumno	
chop	posiekać	
sparkly	świecący	
clobbered	uderzył	
causative verb	czasownik sprawczy	
homage	hołd	
trailblazer	pionier	
all the way back	całą drogę powrotną	
dub	zdubbingować	
upsides	zalety	
smitten	uderzony	
napkin	serwetka	
cramp	skurcz	
vicarious	zastępczy	
ultrasonic	ultradźwiękowy	
melt down	przetapiać	
plausible	do przyjęcia	
molten lead	stopiony ołów	
thoughtful	rozważny	
ballpark	przybliżony zakres	
fleet	flota	
oat to sow	owies do siewu	
chipmunk	wiewiórka	
dustpan	szufelka	
the other way around	na odwrót	
stilt	szczudło	
weenie	Siusiak	
